id,floor_called,timestamp,current_floor,is_vacant,hour,day_of_week,month,floor_diff
1,5,2024-07-23 06:10:21.394220+00:00,26,False,06.10,1,7,-21
2,13,2024-07-23 20:56:52.876259+00:00,18,True,20.56,1,7,-5
3,15,2024-07-23 20:02:56.370314+00:00,24,True,20.02,1,7,-9
4,23,2024-07-23 19:20:03.454307+00:00,27,False,19.20,1,7,-4
5,19,2024-07-23 08:45:01.857151+00:00,18,True,08.45,1,7,1
6,7,2024-07-23 15:39:05.534881+00:00,27,False,15.39,1,7,-20
7,13,2024-07-23 13:19:18.445267+00:00,19,False,13.19,1,7,-6
8,20,2024-07-23 06:23:15.883313+00:00,18,True,06.23,1,7,2
9,20,2024-07-23 09:12:47.228747+00:00,21,True,09.12,1,7,-1
10,16,2024-07-23 10:09:20.924447+00:00,26,True,10.09,1,7,-10
11,2,2024-07-23 10:24:04.093838+00:00,26,False,10.24,1,7,-24
12,27,2024-07-23 02:20:57.720650+00:00,6,False,02.20,1,7,21
13,23,2024-07-23 08:54:39.904605+00:00,11,False,08.54,1,7,12
14,1,2024-07-23 06:44:30.951534+00:00,9,True,06.44,1,7,-8
15,30,2024-07-23 07:09:12.969437+00:00,21,True,07.09,1,7,9
16,22,2024-07-23 02:44:49.682057+00:00,23,True,02.44,1,7,-1
17,1,2024-07-23 21:13:41.777695+00:00,4,True,21.13,1,7,-3
18,0,2024-07-23 15:00:39.134804+00:00,17,True,15.00,1,7,-17
19,18,2024-07-23 16:25:12.338787+00:00,5,True,16.25,1,7,13
20,12,2024-07-23 13:44:00.541552+00:00,24,False,13.44,1,7,-12
21,14,2024-07-23 08:24:17.365954+00:00,1,True,08.24,1,7,13
22,10,2024-07-23 04:28:36.495894+00:00,25,False,04.28,1,7,-15
23,20,2024-07-23 21:28:19.609438+00:00,12,True,21.28,1,7,8
24,5,2024-07-23 15:44:51.454999+00:00,16,False,15.44,1,7,-11
25,25,2024-07-23 05:24:44.649391+00:00,6,False,05.24,1,7,19
26,27,2024-07-23 06:26:48.397241+00:00,27,False,06.26,1,7,0
27,28,2024-07-23 12:45:46.019592+00:00,28,False,12.45,1,7,0
28,17,2024-07-23 09:08:31.285046+00:00,8,False,09.08,1,7,9
29,29,2024-07-23 21:47:24.586756+00:00,8,False,21.47,1,7,21
30,16,2024-07-23 20:52:44.828022+00:00,10,True,20.52,1,7,6
31,10,2024-07-23 20:56:40.873698+00:00,4,True,20.56,1,7,6
32,8,2024-07-23 13:15:22.212481+00:00,23,False,13.15,1,7,-15
33,13,2024-07-23 09:27:28.420830+00:00,22,True,09.27,1,7,-9
34,26,2024-07-23 02:44:44.496641+00:00,18,False,02.44,1,7,8
35,10,2024-07-23 20:19:02.195272+00:00,21,True,20.19,1,7,-11
36,12,2024-07-23 22:13:15.200524+00:00,5,True,22.13,1,7,7
37,2,2024-07-23 22:51:39.144354+00:00,3,True,22.51,1,7,-1
38,12,2024-07-23 10:51:06.156929+00:00,16,True,10.51,1,7,-4
39,9,2024-07-23 19:19:52.822871+00:00,3,False,19.19,1,7,6
40,28,2024-07-23 15:35:50.079491+00:00,13,True,15.35,1,7,15
41,17,2024-07-23 17:25:23.751900+00:00,11,False,17.25,1,7,6
42,11,2024-07-23 01:06:05.078892+00:00,22,True,01.06,1,7,-11
43,27,2024-07-23 21:14:39.441647+00:00,9,False,21.14,1,7,18
44,29,2024-07-23 04:18:54.642475+00:00,2,False,04.18,1,7,27
45,13,2024-07-23 04:46:27.403527+00:00,11,True,04.46,1,7,2
46,10,2024-07-23 09:11:01.461788+00:00,26,True,09.11,1,7,-16
47,24,2024-07-23 00:00:14.964001+00:00,19,False,00.00,1,7,5
48,24,2024-07-23 13:04:01.314073+00:00,13,True,13.04,1,7,11
49,1,2024-07-23 06:43:00.801766+00:00,6,True,06.43,1,7,-5
50,21,2024-07-23 10:46:39.076909+00:00,27,False,10.46,1,7,-6
51,15,2024-07-23 16:26:15.845512+00:00,19,True,16.26,1,7,-4
52,12,2024-07-23 12:31:59.859022+00:00,6,False,12.31,1,7,6
53,30,2024-07-23 21:39:27.838231+00:00,9,True,21.39,1,7,21
54,3,2024-07-23 19:55:52.177139+00:00,26,False,19.55,1,7,-23
55,5,2024-07-23 12:47:04.778316+00:00,13,True,12.47,1,7,-8
56,30,2024-07-23 04:15:00.161775+00:00,17,True,04.15,1,7,13
57,9,2024-07-23 19:59:19.212166+00:00,11,False,19.59,1,7,-2
58,5,2024-07-23 03:20:22.058389+00:00,7,True,03.20,1,7,-2
59,18,2024-07-23 08:19:45.503956+00:00,7,True,08.19,1,7,11
60,29,2024-07-23 23:12:39.817084+00:00,6,True,23.12,1,7,23
61,28,2024-07-23 07:18:24.111186+00:00,28,False,07.18,1,7,0
62,0,2024-07-23 07:43:27.250491+00:00,0,True,07.43,1,7,0
63,15,2024-07-23 19:07:48.288675+00:00,13,False,19.07,1,7,2
64,9,2024-07-23 11:36:58.722288+00:00,23,False,11.36,1,7,-14
65,20,2024-07-23 21:11:55.633210+00:00,27,False,21.11,1,7,-7
66,15,2024-07-23 15:36:40.100642+00:00,23,False,15.36,1,7,-8
67,5,2024-07-23 22:18:16.843264+00:00,1,True,22.18,1,7,4
68,11,2024-07-23 08:41:35.620588+00:00,24,True,08.41,1,7,-13
69,25,2024-07-23 17:40:23.387396+00:00,9,False,17.40,1,7,16
70,22,2024-07-23 16:31:27.337431+00:00,23,False,16.31,1,7,-1
71,18,2024-07-23 21:57:45.747995+00:00,8,False,21.57,1,7,10
72,11,2024-07-23 02:33:03.535147+00:00,28,True,02.33,1,7,-17
73,4,2024-07-23 22:07:59.414469+00:00,1,True,22.07,1,7,3
74,20,2024-07-23 10:47:25.411484+00:00,28,False,10.47,1,7,-8
75,16,2024-07-23 21:24:53.873098+00:00,9,False,21.24,1,7,7
76,19,2024-07-23 12:06:35.236845+00:00,29,True,12.06,1,7,-10
77,7,2024-07-23 16:34:04.991698+00:00,8,True,16.34,1,7,-1
78,4,2024-07-23 05:21:27.031870+00:00,21,False,05.21,1,7,-17
79,12,2024-07-23 01:52:07.829001+00:00,30,True,01.52,1,7,-18
80,25,2024-07-23 08:38:07.041520+00:00,8,False,08.38,1,7,17
81,26,2024-07-23 00:36:32.078329+00:00,0,False,00.36,1,7,26
82,4,2024-07-23 00:10:26.346113+00:00,18,False,00.10,1,7,-14
83,6,2024-07-23 18:44:10.311297+00:00,29,False,18.44,1,7,-23
84,1,2024-07-23 07:50:11.018710+00:00,12,True,07.50,1,7,-11
85,29,2024-07-23 18:29:22.707310+00:00,13,True,18.29,1,7,16
86,21,2024-07-23 11:01:14.494597+00:00,27,True,11.01,1,7,-6
87,1,2024-07-23 14:20:59.958511+00:00,12,True,14.20,1,7,-11
88,30,2024-07-23 15:42:11.784666+00:00,23,True,15.42,1,7,7
89,12,2024-07-23 19:01:18.525885+00:00,1,True,19.01,1,7,11
90,3,2024-07-23 20:25:39.145628+00:00,3,True,20.25,1,7,0
91,17,2024-07-23 08:44:18.945339+00:00,7,False,08.44,1,7,10
92,12,2024-07-23 02:39:31.238139+00:00,13,True,02.39,1,7,-1
93,25,2024-07-23 05:55:52.878637+00:00,0,True,05.55,1,7,25
94,7,2024-07-23 05:31:48.767250+00:00,19,True,05.31,1,7,-12
95,11,2024-07-23 01:06:11.840113+00:00,28,False,01.06,1,7,-17
96,16,2024-07-23 17:20:02.431420+00:00,3,False,17.20,1,7,13
97,12,2024-07-23 06:55:30.217430+00:00,5,True,06.55,1,7,7
98,11,2024-07-23 20:49:14.776551+00:00,17,False,20.49,1,7,-6
99,10,2024-07-23 21:05:48.207642+00:00,11,True,21.05,1,7,-1
100,1,2024-07-23 21:58:52.957690+00:00,25,True,21.58,1,7,-24
101,21,2024-07-23 22:13:52.306502+00:00,6,True,22.13,1,7,15
102,14,2024-07-23 13:14:12.561008+00:00,2,True,13.14,1,7,12
103,16,2024-07-23 03:53:49.835178+00:00,25,False,03.53,1,7,-9
104,14,2024-07-23 07:17:06.368880+00:00,12,False,07.17,1,7,2
105,13,2024-07-23 06:57:17.262207+00:00,8,True,06.57,1,7,5
106,16,2024-07-23 12:05:56.787423+00:00,12,True,12.05,1,7,4
107,14,2024-07-23 16:47:52.442121+00:00,3,False,16.47,1,7,11
108,28,2024-07-23 14:19:52.173863+00:00,6,True,14.19,1,7,22
109,3,2024-07-23 21:22:01.773889+00:00,29,True,21.22,1,7,-26
110,29,2024-07-23 09:26:54.999946+00:00,7,False,09.26,1,7,22
111,8,2024-07-23 20:56:05.838442+00:00,30,True,20.56,1,7,-22
112,29,2024-07-23 14:47:49.910380+00:00,18,True,14.47,1,7,11
113,16,2024-07-23 14:55:26.678472+00:00,6,True,14.55,1,7,10
114,19,2024-07-23 03:25:00.139061+00:00,29,True,03.25,1,7,-10
115,4,2024-07-23 21:29:40.401647+00:00,29,True,21.29,1,7,-25
116,10,2024-07-23 15:57:46.582928+00:00,2,False,15.57,1,7,8
117,6,2024-07-23 03:09:31.192923+00:00,27,False,03.09,1,7,-21
118,12,2024-07-23 18:16:12.686460+00:00,11,True,18.16,1,7,1
119,17,2024-07-23 17:44:40.500865+00:00,20,True,17.44,1,7,-3
120,22,2024-07-23 09:08:11.394837+00:00,15,False,09.08,1,7,7
121,10,2024-07-23 15:33:52.435320+00:00,14,True,15.33,1,7,-4
122,20,2024-07-23 04:17:44.658707+00:00,30,False,04.17,1,7,-10
123,11,2024-07-23 04:39:31.970873+00:00,22,False,04.39,1,7,-11
124,28,2024-07-23 06:09:47.560738+00:00,8,False,06.09,1,7,20
125,23,2024-07-23 08:55:16.321701+00:00,0,True,08.55,1,7,23
126,22,2024-07-23 10:28:44.538087+00:00,0,True,10.28,1,7,22
127,10,2024-07-23 15:18:46.478207+00:00,0,True,15.18,1,7,10
128,25,2024-07-23 05:12:53.338739+00:00,12,False,05.12,1,7,13
129,18,2024-07-23 18:26:29.088673+00:00,26,True,18.26,1,7,-8
130,30,2024-07-23 06:14:51.646129+00:00,28,False,06.14,1,7,2
131,14,2024-07-23 03:20:01.636929+00:00,11,False,03.20,1,7,3
132,23,2024-07-23 02:49:56.289497+00:00,4,False,02.49,1,7,19
133,22,2024-07-23 00:21:17.061062+00:00,3,True,00.21,1,7,19
134,13,2024-07-23 13:44:52.440365+00:00,27,True,13.44,1,7,-14
135,22,2024-07-23 08:53:56.150276+00:00,3,True,08.53,1,7,19
136,19,2024-07-23 19:14:18.098388+00:00,30,False,19.14,1,7,-11
137,1,2024-07-23 03:44:24.253084+00:00,25,False,03.44,1,7,-24
138,26,2024-07-23 03:35:30.517922+00:00,4,False,03.35,1,7,22
139,23,2024-07-22 23:34:14.003864+00:00,28,True,23.34,0,7,-5
140,0,2024-07-23 15:03:54.163255+00:00,20,True,15.03,1,7,-20
141,11,2024-07-23 21:11:54.847764+00:00,30,True,21.11,1,7,-19
142,23,2024-07-23 11:28:38.464566+00:00,27,False,11.28,1,7,-4
143,10,2024-07-23 09:45:20.655603+00:00,9,False,09.45,1,7,1
144,0,2024-07-23 18:16:29.993141+00:00,12,True,18.16,1,7,-12
145,16,2024-07-23 02:39:52.536658+00:00,30,True,02.39,1,7,-14
146,27,2024-07-23 11:05:38.636177+00:00,27,False,11.05,1,7,0
147,6,2024-07-23 11:12:07.104434+00:00,15,True,11.12,1,7,-9
148,2,2024-07-23 13:21:39.756811+00:00,17,True,13.21,1,7,-15
149,22,2024-07-23 13:52:36.914959+00:00,29,True,13.52,1,7,-7
150,13,2024-07-23 14:03:11.429842+00:00,0,False,14.03,1,7,13
151,17,2024-07-23 10:34:42.972474+00:00,1,True,10.34,1,7,16
152,7,2024-07-23 04:18:27.911764+00:00,27,True,04.18,1,7,-20
153,2,2024-07-23 05:37:33.209262+00:00,7,True,05.37,1,7,-5
154,0,2024-07-23 15:56:20.247519+00:00,6,True,15.56,1,7,-6
155,1,2024-07-23 05:34:50.545969+00:00,16,True,05.34,1,7,-15
156,23,2024-07-23 22:16:38.873385+00:00,4,False,22.16,1,7,19
157,8,2024-07-23 13:18:50.886911+00:00,22,True,13.18,1,7,-14
158,15,2024-07-23 02:15:18.138623+00:00,11,True,02.15,1,7,4
159,11,2024-07-23 03:51:40.422108+00:00,12,True,03.51,1,7,-1
160,2,2024-07-23 10:50:20.885751+00:00,18,False,10.50,1,7,-16
161,11,2024-07-23 03:18:37.177914+00:00,11,False,03.18,1,7,0
162,3,2024-07-23 17:50:56.102858+00:00,21,False,17.50,1,7,-18
163,12,2024-07-23 03:27:15.098059+00:00,6,True,03.27,1,7,6
164,17,2024-07-23 06:21:55.367773+00:00,27,True,06.21,1,7,-10
165,10,2024-07-23 09:43:30.230204+00:00,9,False,09.43,1,7,1
166,9,2024-07-23 09:13:58.995166+00:00,19,True,09.13,1,7,-10
167,4,2024-07-23 10:24:18.451885+00:00,20,False,10.24,1,7,-16
168,9,2024-07-23 17:47:39.277736+00:00,23,False,17.47,1,7,-14
169,1,2024-07-23 18:44:41.561021+00:00,9,False,18.44,1,7,-8
170,5,2024-07-23 11:52:04.896845+00:00,25,False,11.52,1,7,-20
171,1,2024-07-23 12:01:05.351698+00:00,25,True,12.01,1,7,-24
172,19,2024-07-23 20:37:35.806139+00:00,13,False,20.37,1,7,6
173,25,2024-07-23 21:03:08.337967+00:00,17,True,21.03,1,7,8
174,19,2024-07-23 06:33:04.881740+00:00,11,False,06.33,1,7,8
175,30,2024-07-23 11:50:43.476836+00:00,11,False,11.50,1,7,19
176,8,2024-07-23 11:26:15.648924+00:00,14,False,11.26,1,7,-6
177,30,2024-07-23 08:31:38.512964+00:00,18,False,08.31,1,7,12
178,11,2024-07-23 09:07:42.786034+00:00,22,True,09.07,1,7,-11
179,27,2024-07-23 19:13:01.350702+00:00,9,False,19.13,1,7,18
180,3,2024-07-23 08:19:42.530852+00:00,9,True,08.19,1,7,-6
181,24,2024-07-23 05:21:29.859220+00:00,25,True,05.21,1,7,-1
182,25,2024-07-23 15:40:47.888637+00:00,9,True,15.40,1,7,16
183,12,2024-07-23 19:21:17.844443+00:00,14,True,19.21,1,7,-2
184,27,2024-07-23 04:24:01.303802+00:00,29,True,04.24,1,7,-2
185,4,2024-07-23 09:14:07.256584+00:00,21,False,09.14,1,7,-17
186,4,2024-07-23 04:02:16.769408+00:00,22,True,04.02,1,7,-18
187,20,2024-07-23 10:04:39.886523+00:00,3,True,10.04,1,7,17
188,16,2024-07-23 20:59:50.534036+00:00,24,True,20.59,1,7,-8
189,27,2024-07-23 09:53:44.889216+00:00,21,False,09.53,1,7,6
190,9,2024-07-23 11:53:19.376119+00:00,12,True,11.53,1,7,-3
191,3,2024-07-23 04:10:09.581345+00:00,26,False,04.10,1,7,-23
192,26,2024-07-23 15:21:49.833772+00:00,27,True,15.21,1,7,-1
193,12,2024-07-23 19:28:12.181957+00:00,14,False,19.28,1,7,-2
194,9,2024-07-23 01:44:51.269495+00:00,14,False,01.44,1,7,-5
195,21,2024-07-23 16:28:50.609653+00:00,4,False,16.28,1,7,17
196,4,2024-07-23 12:53:02.011668+00:00,3,True,12.53,1,7,1
197,9,2024-07-23 10:30:24.263384+00:00,4,True,10.30,1,7,5
198,16,2024-07-23 22:52:34.466475+00:00,21,True,22.52,1,7,-5
199,28,2024-07-23 15:28:21.396207+00:00,13,False,15.28,1,7,15
200,30,2024-07-23 20:05:27.276300+00:00,24,False,20.05,1,7,6
201,16,2024-07-23 10:27:25.609900+00:00,26,True,10.27,1,7,-10
202,7,2024-07-23 11:00:15.408508+00:00,18,False,11.00,1,7,-11
203,18,2024-07-23 23:26:19.976085+00:00,0,True,23.26,1,7,18
204,3,2024-07-23 11:23:49.503164+00:00,11,True,11.23,1,7,-8
205,6,2024-07-23 00:31:30.121377+00:00,8,True,00.31,1,7,-2
206,3,2024-07-23 02:11:06.753424+00:00,21,False,02.11,1,7,-18
207,6,2024-07-23 09:50:07.960943+00:00,18,True,09.50,1,7,-12
208,6,2024-07-23 17:59:21.881487+00:00,29,False,17.59,1,7,-23
209,25,2024-07-23 14:16:26.692481+00:00,20,False,14.16,1,7,5
210,24,2024-07-23 22:06:56.373939+00:00,21,True,22.06,1,7,3
211,28,2024-07-23 09:11:49.923525+00:00,3,False,09.11,1,7,25
212,27,2024-07-23 22:00:33.693656+00:00,14,True,22.00,1,7,13
213,23,2024-07-23 03:43:12.986336+00:00,2,True,03.43,1,7,21
214,25,2024-07-23 00:57:07.716445+00:00,21,True,00.57,1,7,4
215,22,2024-07-23 05:08:00.343143+00:00,8,True,05.08,1,7,14
216,23,2024-07-23 01:44:45.987081+00:00,8,True,01.44,1,7,15
217,7,2024-07-23 18:02:10.209907+00:00,23,False,18.02,1,7,-16
218,28,2024-07-23 00:25:05.138004+00:00,16,False,00.25,1,7,12
219,17,2024-07-23 04:26:08.289176+00:00,20,False,04.26,1,7,-3
220,24,2024-07-23 18:01:37.410544+00:00,25,True,18.01,1,7,-1
221,2,2024-07-23 06:33:19.882285+00:00,18,False,06.33,1,7,-16
222,10,2024-07-23 23:17:00.159900+00:00,14,False,23.17,1,7,-4
223,16,2024-07-23 15:55:42.612280+00:00,28,True,15.55,1,7,-12
224,24,2024-07-23 01:25:04.450609+00:00,17,True,01.25,1,7,7
225,27,2024-07-23 04:39:38.196075+00:00,7,True,04.39,1,7,20
226,5,2024-07-23 21:59:31.666000+00:00,11,False,21.59,1,7,-6
227,6,2024-07-23 07:46:35.611757+00:00,9,True,07.46,1,7,-3
228,22,2024-07-23 13:38:41.390703+00:00,1,False,13.38,1,7,21
229,22,2024-07-23 13:06:34.872739+00:00,17,False,13.06,1,7,5
230,19,2024-07-23 12:22:55.720902+00:00,13,True,12.22,1,7,6
231,17,2024-07-23 03:52:37.145085+00:00,27,True,03.52,1,7,-10
232,27,2024-07-23 16:55:39.848657+00:00,13,False,16.55,1,7,14
233,24,2024-07-23 09:32:05.266787+00:00,3,True,09.32,1,7,21
234,25,2024-07-23 06:43:10.405325+00:00,2,False,06.43,1,7,23
235,12,2024-07-23 11:59:13.444842+00:00,14,True,11.59,1,7,-2
236,13,2024-07-23 08:23:34.089217+00:00,2,True,08.23,1,7,11
237,0,2024-07-23 15:45:01.986874+00:00,10,False,15.45,1,7,-10
238,15,2024-07-23 13:31:41.307403+00:00,29,False,13.31,1,7,-14
239,9,2024-07-23 15:50:02.494789+00:00,28,False,15.50,1,7,-19
240,20,2024-07-23 00:11:07.958664+00:00,12,True,00.11,1,7,8
241,20,2024-07-22 23:50:13.584476+00:00,17,True,23.50,0,7,3
242,27,2024-07-23 04:13:13.275968+00:00,8,False,04.13,1,7,19
243,30,2024-07-23 12:39:29.939057+00:00,4,True,12.39,1,7,26
244,4,2024-07-23 14:31:36.285500+00:00,9,False,14.31,1,7,-5
245,6,2024-07-23 05:43:41.729356+00:00,23,False,05.43,1,7,-17
246,26,2024-07-23 19:19:43.187521+00:00,29,True,19.19,1,7,-3
247,11,2024-07-23 15:10:07.615574+00:00,18,True,15.10,1,7,-7
248,30,2024-07-23 19:15:47.818675+00:00,9,False,19.15,1,7,21
249,14,2024-07-23 03:58:38.931981+00:00,14,False,03.58,1,7,0
250,13,2024-07-23 22:19:55.422297+00:00,6,True,22.19,1,7,7
251,25,2024-07-23 17:28:32.186426+00:00,11,True,17.28,1,7,14
252,0,2024-07-23 13:30:13.417276+00:00,17,True,13.30,1,7,-17
253,24,2024-07-22 23:57:50.394478+00:00,28,True,23.57,0,7,-4
254,5,2024-07-23 11:10:40.834094+00:00,25,True,11.10,1,7,-20
255,27,2024-07-23 18:36:47.574929+00:00,5,True,18.36,1,7,22
256,15,2024-07-23 08:24:38.182075+00:00,18,True,08.24,1,7,-3
257,21,2024-07-23 00:12:14.646484+00:00,23,True,00.12,1,7,-2
258,21,2024-07-23 00:57:33.336503+00:00,24,True,00.57,1,7,-3
259,4,2024-07-23 16:21:22.467345+00:00,26,False,16.21,1,7,-22
260,22,2024-07-23 21:31:40.918200+00:00,9,True,21.31,1,7,13
261,28,2024-07-23 06:03:23.968559+00:00,7,False,06.03,1,7,21
262,30,2024-07-23 02:15:53.514185+00:00,5,True,02.15,1,7,25
263,29,2024-07-23 05:58:30.078448+00:00,22,True,05.58,1,7,7
264,12,2024-07-23 21:49:44.213957+00:00,15,True,21.49,1,7,-3
265,26,2024-07-23 22:42:08.064738+00:00,26,False,22.42,1,7,0
266,0,2024-07-23 10:39:15.809794+00:00,7,False,10.39,1,7,-7
267,8,2024-07-23 08:47:27.092887+00:00,26,False,08.47,1,7,-18
268,20,2024-07-23 12:42:08.187398+00:00,23,True,12.42,1,7,-3
269,28,2024-07-23 10:41:06.163031+00:00,24,False,10.41,1,7,4
270,29,2024-07-23 12:39:20.158362+00:00,29,True,12.39,1,7,0
271,6,2024-07-23 09:22:20.148838+00:00,6,True,09.22,1,7,0
272,29,2024-07-23 05:10:35.387393+00:00,22,False,05.10,1,7,7
273,22,2024-07-23 02:27:19.568956+00:00,10,True,02.27,1,7,12
274,24,2024-07-23 01:24:46.623460+00:00,14,True,01.24,1,7,10
275,10,2024-07-23 09:12:12.773883+00:00,18,False,09.12,1,7,-8
276,22,2024-07-23 15:54:12.229513+00:00,22,False,15.54,1,7,0
277,13,2024-07-23 18:12:38.697173+00:00,11,True,18.12,1,7,2
278,15,2024-07-23 14:40:24.556429+00:00,1,False,14.40,1,7,14
279,19,2024-07-23 16:34:27.596919+00:00,18,True,16.34,1,7,1
280,26,2024-07-23 08:07:45.228518+00:00,21,True,08.07,1,7,5
281,10,2024-07-23 22:05:06.041550+00:00,19,False,22.05,1,7,-9
282,7,2024-07-23 17:30:35.214617+00:00,15,False,17.30,1,7,-8
283,22,2024-07-23 11:45:35.406939+00:00,26,False,11.45,1,7,-4
284,9,2024-07-23 05:16:26.549822+00:00,13,True,05.16,1,7,-4
285,18,2024-07-23 03:16:44.605987+00:00,14,True,03.16,1,7,4
286,18,2024-07-23 08:48:29.556155+00:00,0,False,08.48,1,7,18
287,3,2024-07-23 14:43:59.649926+00:00,25,False,14.43,1,7,-22
288,14,2024-07-23 03:21:18.757055+00:00,25,True,03.21,1,7,-11
289,15,2024-07-23 23:41:25.297224+00:00,18,False,23.41,1,7,-3
290,7,2024-07-23 02:31:43.935816+00:00,6,False,02.31,1,7,1
291,22,2024-07-23 00:21:10.824229+00:00,5,True,00.21,1,7,17
292,0,2024-07-23 01:06:10.872933+00:00,13,True,01.06,1,7,-13
293,5,2024-07-23 22:10:01.913780+00:00,21,True,22.10,1,7,-16
294,26,2024-07-23 23:18:21.355631+00:00,11,True,23.18,1,7,15
295,22,2024-07-23 18:39:42.329415+00:00,26,True,18.39,1,7,-4
296,23,2024-07-23 14:26:18.882360+00:00,6,False,14.26,1,7,17
297,0,2024-07-23 12:49:52.575608+00:00,19,True,12.49,1,7,-19
298,1,2024-07-23 09:57:03.490499+00:00,5,True,09.57,1,7,-4
299,2,2024-07-23 22:48:39.184536+00:00,27,False,22.48,1,7,-25
300,3,2024-07-23 07:17:32.373105+00:00,10,True,07.17,1,7,-7
301,29,2024-07-23 23:40:17.788225+00:00,9,True,23.40,1,7,20
302,21,2024-07-23 08:28:35.892490+00:00,13,False,08.28,1,7,8
303,21,2024-07-23 08:28:51.364098+00:00,0,True,08.28,1,7,21
304,27,2024-07-23 00:49:39.691031+00:00,16,False,00.49,1,7,11
305,25,2024-07-23 07:56:56.953657+00:00,17,False,07.56,1,7,8
306,5,2024-07-23 20:43:56.002796+00:00,20,True,20.43,1,7,-15
307,6,2024-07-23 06:08:09.792403+00:00,26,False,06.08,1,7,-20
308,4,2024-07-23 12:59:34.968633+00:00,18,False,12.59,1,7,-14
309,20,2024-07-23 17:42:42.098628+00:00,8,False,17.42,1,7,12
310,27,2024-07-23 00:39:48.241853+00:00,1,True,00.39,1,7,26
311,28,2024-07-23 10:26:22.148823+00:00,29,False,10.26,1,7,-1
312,14,2024-07-23 11:14:10.107587+00:00,0,True,11.14,1,7,14
313,25,2024-07-23 06:14:25.400768+00:00,24,True,06.14,1,7,1
314,13,2024-07-23 12:46:46.356950+00:00,17,False,12.46,1,7,-4
315,2,2024-07-23 14:57:48.909474+00:00,18,True,14.57,1,7,-16
316,25,2024-07-23 00:58:55.893663+00:00,24,True,00.58,1,7,1
317,29,2024-07-23 11:20:15.087521+00:00,18,True,11.20,1,7,11
318,15,2024-07-23 07:43:23.978884+00:00,17,True,07.43,1,7,-2
319,30,2024-07-23 23:42:33.331721+00:00,21,False,23.42,1,7,9
320,27,2024-07-23 01:48:24.996710+00:00,1,True,01.48,1,7,26
321,10,2024-07-23 18:41:44.736403+00:00,25,False,18.41,1,7,-15
322,4,2024-07-23 17:25:41.665717+00:00,12,False,17.25,1,7,-8
323,25,2024-07-23 14:16:50.589159+00:00,10,True,14.16,1,7,15
324,12,2024-07-23 05:02:49.943050+00:00,5,True,05.02,1,7,7
325,10,2024-07-23 06:59:49.123782+00:00,10,True,06.59,1,7,0
326,9,2024-07-23 18:42:38.424904+00:00,25,True,18.42,1,7,-16
327,0,2024-07-23 00:35:03.106236+00:00,15,False,00.35,1,7,-15
328,24,2024-07-23 00:19:31.390296+00:00,16,True,00.19,1,7,8
329,18,2024-07-23 20:42:52.979504+00:00,25,True,20.42,1,7,-7
330,21,2024-07-23 16:16:35.652568+00:00,22,False,16.16,1,7,-1
331,24,2024-07-23 14:22:00.784653+00:00,12,False,14.22,1,7,12
332,14,2024-07-23 21:18:22.839038+00:00,10,False,21.18,1,7,4
333,20,2024-07-23 02:09:27.019931+00:00,25,True,02.09,1,7,-5
334,13,2024-07-23 00:04:03.095749+00:00,28,False,00.04,1,7,-15
335,30,2024-07-23 08:18:13.141029+00:00,26,True,08.18,1,7,4
336,12,2024-07-23 14:22:58.261448+00:00,3,False,14.22,1,7,9
337,19,2024-07-23 00:33:59.393281+00:00,13,False,00.33,1,7,6
338,18,2024-07-23 22:53:01.525144+00:00,28,True,22.53,1,7,-10
339,13,2024-07-23 03:55:41.457459+00:00,5,True,03.55,1,7,8
340,1,2024-07-23 11:30:35.902924+00:00,27,False,11.30,1,7,-26
341,21,2024-07-23 13:21:03.038250+00:00,1,True,13.21,1,7,20
342,29,2024-07-23 23:01:14.256687+00:00,30,True,23.01,1,7,-1
343,1,2024-07-23 18:53:55.185296+00:00,29,False,18.53,1,7,-28
344,20,2024-07-23 04:03:08.391999+00:00,23,True,04.03,1,7,-3
345,6,2024-07-23 12:13:45.185149+00:00,24,False,12.13,1,7,-18
346,0,2024-07-23 16:36:15.268333+00:00,23,False,16.36,1,7,-23
347,26,2024-07-23 00:55:28.883258+00:00,2,True,00.55,1,7,24
348,9,2024-07-23 10:21:55.385432+00:00,23,True,10.21,1,7,-14
349,9,2024-07-23 02:33:04.100734+00:00,25,False,02.33,1,7,-16
350,1,2024-07-23 23:36:30.886747+00:00,22,True,23.36,1,7,-21
351,4,2024-07-23 06:05:59.764104+00:00,29,True,06.05,1,7,-25
352,16,2024-07-23 11:57:42.153374+00:00,5,True,11.57,1,7,11
353,17,2024-07-23 13:14:45.284074+00:00,9,True,13.14,1,7,8
354,14,2024-07-23 00:39:11.860215+00:00,8,True,00.39,1,7,6
355,24,2024-07-23 12:21:50.254710+00:00,19,True,12.21,1,7,5
356,14,2024-07-23 00:15:21.300976+00:00,17,False,00.15,1,7,-3
357,24,2024-07-23 04:22:35.332041+00:00,23,True,04.22,1,7,1
358,5,2024-07-23 07:57:02.388277+00:00,6,False,07.57,1,7,-1
359,18,2024-07-23 01:36:56.603230+00:00,11,True,01.36,1,7,7
360,10,2024-07-23 11:27:52.648664+00:00,17,False,11.27,1,7,-7
361,4,2024-07-23 10:36:36.691819+00:00,3,False,10.36,1,7,1
362,12,2024-07-23 09:00:04.914580+00:00,15,True,09.00,1,7,-3
363,13,2024-07-23 00:20:30.227694+00:00,29,True,00.20,1,7,-16
364,1,2024-07-23 12:38:43.195296+00:00,29,True,12.38,1,7,-28
365,19,2024-07-23 04:20:37.026383+00:00,8,False,04.20,1,7,11
366,25,2024-07-23 15:59:19.706204+00:00,27,False,15.59,1,7,-2
367,21,2024-07-23 20:34:57.704612+00:00,8,True,20.34,1,7,13
368,12,2024-07-23 12:56:34.981023+00:00,6,True,12.56,1,7,6
369,2,2024-07-23 19:13:46.326930+00:00,14,True,19.13,1,7,-12
370,18,2024-07-23 17:51:01.603281+00:00,19,True,17.51,1,7,-1
371,30,2024-07-23 15:14:00.703550+00:00,2,False,15.14,1,7,28
372,5,2024-07-23 00:09:36.277365+00:00,8,True,00.09,1,7,-3
373,12,2024-07-23 22:35:05.752069+00:00,20,False,22.35,1,7,-8
374,3,2024-07-23 10:56:48.283148+00:00,27,False,10.56,1,7,-24
375,30,2024-07-23 06:58:08.707702+00:00,17,False,06.58,1,7,13
376,21,2024-07-23 09:46:42.623913+00:00,12,False,09.46,1,7,9
377,28,2024-07-23 10:19:18.406614+00:00,6,False,10.19,1,7,22
378,8,2024-07-23 17:03:23.077893+00:00,4,True,17.03,1,7,4
379,7,2024-07-23 04:51:20.961615+00:00,24,True,04.51,1,7,-17
380,27,2024-07-23 20:39:51.901427+00:00,16,False,20.39,1,7,11
381,16,2024-07-23 09:38:44.057596+00:00,14,False,09.38,1,7,2
382,6,2024-07-23 00:16:10.753001+00:00,26,True,00.16,1,7,-20
383,15,2024-07-23 21:06:07.478683+00:00,1,True,21.06,1,7,14
384,17,2024-07-23 06:26:51.493508+00:00,29,False,06.26,1,7,-12
385,21,2024-07-23 13:18:06.582460+00:00,10,True,13.18,1,7,11
386,18,2024-07-23 10:57:19.851972+00:00,4,False,10.57,1,7,14
387,15,2024-07-23 19:26:41.555182+00:00,12,True,19.26,1,7,3
388,10,2024-07-23 08:22:52.608284+00:00,4,True,08.22,1,7,6
389,13,2024-07-23 00:41:05.111846+00:00,18,False,00.41,1,7,-5
390,7,2024-07-23 01:10:00.386293+00:00,24,False,01.10,1,7,-17
391,5,2024-07-23 02:25:36.690561+00:00,13,True,02.25,1,7,-8
392,18,2024-07-23 22:07:13.199151+00:00,26,True,22.07,1,7,-8
393,0,2024-07-23 15:26:59.675953+00:00,28,True,15.26,1,7,-28
394,23,2024-07-23 21:49:56.131943+00:00,14,True,21.49,1,7,9
395,1,2024-07-23 10:31:59.520846+00:00,28,False,10.31,1,7,-27
396,11,2024-07-23 09:59:27.655678+00:00,3,False,09.59,1,7,8
397,6,2024-07-23 23:29:59.026307+00:00,7,True,23.29,1,7,-1
398,6,2024-07-23 05:08:14.566863+00:00,30,True,05.08,1,7,-24
399,5,2024-07-23 05:30:10.742418+00:00,29,False,05.30,1,7,-24
400,17,2024-07-23 03:23:12.866472+00:00,17,True,03.23,1,7,0
401,17,2024-07-23 09:49:53.364527+00:00,23,True,09.49,1,7,-6
402,17,2024-07-23 05:41:34.110237+00:00,8,False,05.41,1,7,9
403,23,2024-07-23 17:45:00.806273+00:00,5,False,17.45,1,7,18
404,11,2024-07-23 06:21:06.622086+00:00,26,True,06.21,1,7,-15
405,0,2024-07-23 23:26:36.892745+00:00,17,False,23.26,1,7,-17
406,1,2024-07-23 20:46:38.201980+00:00,30,True,20.46,1,7,-29
407,1,2024-07-23 00:36:51.406654+00:00,6,False,00.36,1,7,-5
408,11,2024-07-23 06:02:26.204873+00:00,16,True,06.02,1,7,-5
409,9,2024-07-23 13:47:51.366212+00:00,16,False,13.47,1,7,-7
410,28,2024-07-23 06:24:14.945235+00:00,18,False,06.24,1,7,10
411,17,2024-07-23 18:56:21.508548+00:00,23,False,18.56,1,7,-6
412,2,2024-07-23 19:51:22.879447+00:00,29,False,19.51,1,7,-27
413,10,2024-07-23 08:12:15.045464+00:00,22,False,08.12,1,7,-12
414,20,2024-07-23 14:18:04.640266+00:00,12,True,14.18,1,7,8
415,8,2024-07-23 13:09:49.900388+00:00,6,False,13.09,1,7,2
416,4,2024-07-23 09:01:09.326069+00:00,29,False,09.01,1,7,-25
417,20,2024-07-23 08:09:24.722478+00:00,17,True,08.09,1,7,3
418,16,2024-07-23 03:22:08.500587+00:00,17,False,03.22,1,7,-1
419,27,2024-07-23 16:47:44.144817+00:00,0,True,16.47,1,7,27
420,22,2024-07-23 09:36:06.479063+00:00,23,True,09.36,1,7,-1
421,24,2024-07-23 14:43:00.077356+00:00,21,False,14.43,1,7,3
422,8,2024-07-23 13:19:32.637324+00:00,9,True,13.19,1,7,-1
423,28,2024-07-23 16:20:51.785761+00:00,17,False,16.20,1,7,11
424,9,2024-07-23 08:49:08.513590+00:00,0,False,08.49,1,7,9
425,9,2024-07-23 08:29:23.814003+00:00,10,False,08.29,1,7,-1
426,21,2024-07-23 05:56:26.986643+00:00,14,True,05.56,1,7,7
427,4,2024-07-23 05:14:17.234838+00:00,24,False,05.14,1,7,-20
428,22,2024-07-23 19:03:48.969823+00:00,16,False,19.03,1,7,6
429,29,2024-07-23 15:11:26.067375+00:00,1,True,15.11,1,7,28
430,0,2024-07-23 13:36:11.042431+00:00,20,True,13.36,1,7,-20
431,7,2024-07-23 01:02:51.201749+00:00,21,True,01.02,1,7,-14
432,22,2024-07-23 15:31:20.973682+00:00,25,True,15.31,1,7,-3
433,21,2024-07-23 12:14:51.016678+00:00,26,True,12.14,1,7,-5
434,13,2024-07-23 23:12:17.767848+00:00,29,True,23.12,1,7,-16
435,14,2024-07-23 07:28:51.716273+00:00,27,False,07.28,1,7,-13
436,16,2024-07-23 14:16:28.861080+00:00,14,True,14.16,1,7,2
437,19,2024-07-23 01:23:00.572092+00:00,5,True,01.23,1,7,14
438,7,2024-07-23 22:09:22.066456+00:00,16,True,22.09,1,7,-9
439,19,2024-07-23 10:01:16.720483+00:00,24,True,10.01,1,7,-5
440,29,2024-07-23 11:22:25.271661+00:00,11,False,11.22,1,7,18
441,6,2024-07-23 18:36:15.344090+00:00,15,False,18.36,1,7,-9
442,23,2024-07-23 05:31:49.182578+00:00,16,False,05.31,1,7,7
443,5,2024-07-23 21:10:17.677110+00:00,17,False,21.10,1,7,-12
444,0,2024-07-23 18:49:11.936274+00:00,21,False,18.49,1,7,-21
445,7,2024-07-23 22:01:25.664964+00:00,16,True,22.01,1,7,-9
446,4,2024-07-23 11:18:52.467089+00:00,16,False,11.18,1,7,-12
447,0,2024-07-23 21:56:20.194738+00:00,3,True,21.56,1,7,-3
448,1,2024-07-23 07:23:39.924871+00:00,28,False,07.23,1,7,-27
449,1,2024-07-23 09:45:07.296784+00:00,17,False,09.45,1,7,-16
450,25,2024-07-23 16:12:32.988323+00:00,9,True,16.12,1,7,16
451,9,2024-07-23 03:48:42.820430+00:00,20,True,03.48,1,7,-11
452,19,2024-07-23 20:51:28.222884+00:00,2,True,20.51,1,7,17
453,22,2024-07-23 00:49:53.014383+00:00,26,False,00.49,1,7,-4
454,13,2024-07-23 01:23:55.090697+00:00,7,False,01.23,1,7,6
455,7,2024-07-23 07:01:27.452591+00:00,18,True,07.01,1,7,-11
456,22,2024-07-23 23:35:45.259389+00:00,12,True,23.35,1,7,10
457,17,2024-07-23 22:38:34.407925+00:00,30,False,22.38,1,7,-13
458,10,2024-07-23 05:55:11.561471+00:00,9,False,05.55,1,7,1
459,16,2024-07-23 00:05:04.745443+00:00,13,False,00.05,1,7,3
460,5,2024-07-23 03:54:18.981772+00:00,24,False,03.54,1,7,-19
461,8,2024-07-23 05:26:06.557212+00:00,1,False,05.26,1,7,7
462,4,2024-07-23 13:33:04.677211+00:00,16,True,13.33,1,7,-12
463,21,2024-07-23 10:46:38.822299+00:00,24,True,10.46,1,7,-3
464,3,2024-07-23 10:55:16.129443+00:00,17,True,10.55,1,7,-14
465,2,2024-07-23 18:54:47.741387+00:00,18,False,18.54,1,7,-16
466,25,2024-07-23 00:40:56.061739+00:00,14,True,00.40,1,7,11
467,2,2024-07-23 06:23:49.304458+00:00,26,True,06.23,1,7,-24
468,28,2024-07-23 15:28:37.557499+00:00,16,True,15.28,1,7,12
469,8,2024-07-23 05:02:13.158618+00:00,17,True,05.02,1,7,-9
470,22,2024-07-23 18:38:50.965786+00:00,2,False,18.38,1,7,20
471,1,2024-07-23 07:23:27.912493+00:00,7,True,07.23,1,7,-6
472,28,2024-07-23 14:39:49.220318+00:00,19,True,14.39,1,7,9
473,28,2024-07-23 17:20:30.837593+00:00,10,True,17.20,1,7,18
474,25,2024-07-23 21:17:08.865940+00:00,26,False,21.17,1,7,-1
475,22,2024-07-23 14:03:26.285395+00:00,0,False,14.03,1,7,22
476,8,2024-07-23 16:14:12.951291+00:00,26,False,16.14,1,7,-18
477,12,2024-07-23 11:44:28.411137+00:00,28,False,11.44,1,7,-16
478,20,2024-07-23 08:57:25.327754+00:00,23,True,08.57,1,7,-3
479,1,2024-07-23 05:14:14.363056+00:00,12,True,05.14,1,7,-11
480,17,2024-07-23 09:45:38.454942+00:00,29,False,09.45,1,7,-12
481,22,2024-07-23 23:11:13.523295+00:00,13,True,23.11,1,7,9
482,19,2024-07-23 13:11:17.253746+00:00,7,False,13.11,1,7,12
483,16,2024-07-23 03:44:29.857396+00:00,25,False,03.44,1,7,-9
484,1,2024-07-23 20:50:32.646338+00:00,6,False,20.50,1,7,-5
485,5,2024-07-23 06:57:43.932885+00:00,21,False,06.57,1,7,-16
486,15,2024-07-23 11:42:08.503258+00:00,10,True,11.42,1,7,5
487,14,2024-07-23 01:30:47.983596+00:00,1,False,01.30,1,7,13
488,10,2024-07-23 12:13:31.007162+00:00,7,False,12.13,1,7,3
489,26,2024-07-23 00:17:37.192784+00:00,12,True,00.17,1,7,14
490,5,2024-07-23 17:36:43.978900+00:00,12,False,17.36,1,7,-7
491,21,2024-07-23 16:35:41.418412+00:00,17,False,16.35,1,7,4
492,12,2024-07-23 02:43:19.118651+00:00,14,False,02.43,1,7,-2
493,5,2024-07-23 22:34:36.263910+00:00,6,False,22.34,1,7,-1
494,19,2024-07-23 02:14:11.030598+00:00,5,False,02.14,1,7,14
495,21,2024-07-23 11:25:27.568113+00:00,30,True,11.25,1,7,-9
496,12,2024-07-23 23:52:33.876213+00:00,27,False,23.52,1,7,-15
497,6,2024-07-23 00:09:59.281624+00:00,11,True,00.09,1,7,-5
498,27,2024-07-23 20:06:07.623688+00:00,2,True,20.06,1,7,25
499,4,2024-07-23 17:18:38.866706+00:00,23,False,17.18,1,7,-19
500,29,2024-07-23 02:19:45.646549+00:00,1,True,02.19,1,7,28
501,23,2024-07-23 01:33:26.967852+00:00,11,True,01.33,1,7,12
502,12,2024-07-23 02:22:41.072292+00:00,24,True,02.22,1,7,-12
503,24,2024-07-23 20:06:26.436536+00:00,1,False,20.06,1,7,23
504,18,2024-07-23 10:49:35.455057+00:00,12,True,10.49,1,7,6
505,15,2024-07-23 02:33:38.859877+00:00,3,True,02.33,1,7,12
506,27,2024-07-23 06:23:14.527019+00:00,12,False,06.23,1,7,15
507,22,2024-07-23 20:38:56.348082+00:00,11,True,20.38,1,7,11
508,16,2024-07-23 04:29:57.328996+00:00,25,False,04.29,1,7,-9
509,21,2024-07-23 04:20:46.874447+00:00,2,True,04.20,1,7,19
510,7,2024-07-23 03:09:55.285062+00:00,10,True,03.09,1,7,-3
511,20,2024-07-23 13:17:51.063087+00:00,16,True,13.17,1,7,4
512,8,2024-07-23 04:23:42.054315+00:00,18,False,04.23,1,7,-10
513,29,2024-07-23 07:17:20.061588+00:00,23,True,07.17,1,7,6
514,18,2024-07-23 03:23:22.703165+00:00,16,False,03.23,1,7,2
515,30,2024-07-23 07:14:26.423444+00:00,3,True,07.14,1,7,27
516,14,2024-07-23 17:16:03.995919+00:00,15,True,17.16,1,7,-1
517,20,2024-07-23 14:43:30.809751+00:00,14,True,14.43,1,7,6
518,12,2024-07-23 01:27:24.225513+00:00,30,False,01.27,1,7,-18
519,21,2024-07-23 23:24:55.948182+00:00,27,True,23.24,1,7,-6
520,21,2024-07-23 04:58:25.839339+00:00,23,True,04.58,1,7,-2
521,27,2024-07-23 07:16:23.200192+00:00,19,False,07.16,1,7,8
522,18,2024-07-23 21:02:05.596484+00:00,0,False,21.02,1,7,18
523,11,2024-07-23 09:35:50.355924+00:00,17,True,09.35,1,7,-6
524,16,2024-07-23 13:16:23.770775+00:00,6,True,13.16,1,7,10
525,8,2024-07-23 04:48:08.764439+00:00,10,False,04.48,1,7,-2
526,1,2024-07-23 04:14:39.929706+00:00,29,True,04.14,1,7,-28
527,26,2024-07-23 02:50:53.063814+00:00,26,True,02.50,1,7,0
528,29,2024-07-23 00:05:09.074165+00:00,3,False,00.05,1,7,26
529,14,2024-07-23 12:17:12.139609+00:00,4,False,12.17,1,7,10
530,17,2024-07-23 14:38:05.267184+00:00,19,False,14.38,1,7,-2
531,1,2024-07-23 10:07:40.919771+00:00,8,True,10.07,1,7,-7
532,13,2024-07-23 12:27:33.977672+00:00,18,True,12.27,1,7,-5
533,8,2024-07-23 14:07:47.743773+00:00,18,False,14.07,1,7,-10
534,6,2024-07-23 03:42:38.795712+00:00,17,True,03.42,1,7,-11
535,3,2024-07-23 02:43:14.295629+00:00,19,False,02.43,1,7,-16
536,17,2024-07-23 10:57:59.319642+00:00,29,False,10.57,1,7,-12
537,5,2024-07-23 01:25:32.478759+00:00,0,False,01.25,1,7,5
538,14,2024-07-23 12:38:19.868254+00:00,14,False,12.38,1,7,0
539,21,2024-07-23 02:53:49.493982+00:00,14,True,02.53,1,7,7
540,8,2024-07-23 14:27:33.174106+00:00,10,False,14.27,1,7,-2
541,19,2024-07-23 04:11:21.394318+00:00,0,True,04.11,1,7,19
542,24,2024-07-23 04:30:43.845369+00:00,4,False,04.30,1,7,20
543,24,2024-07-23 17:15:23.786250+00:00,13,True,17.15,1,7,11
544,7,2024-07-23 12:47:19.481529+00:00,11,False,12.47,1,7,-4
545,28,2024-07-23 18:06:23.721376+00:00,28,True,18.06,1,7,0
546,24,2024-07-23 02:24:14.644116+00:00,18,True,02.24,1,7,6
547,8,2024-07-23 11:59:31.449513+00:00,8,False,11.59,1,7,0
548,10,2024-07-23 00:19:05.443918+00:00,23,False,00.19,1,7,-13
549,18,2024-07-23 18:37:34.313012+00:00,25,True,18.37,1,7,-7
550,6,2024-07-23 14:50:06.721695+00:00,4,True,14.50,1,7,2
551,5,2024-07-23 23:10:15.737966+00:00,9,True,23.10,1,7,-4
552,27,2024-07-23 20:08:43.844335+00:00,21,False,20.08,1,7,6
553,20,2024-07-23 21:14:37.837638+00:00,20,False,21.14,1,7,0
554,7,2024-07-23 16:52:33.915618+00:00,22,True,16.52,1,7,-15
555,24,2024-07-23 04:19:26.614956+00:00,12,True,04.19,1,7,12
556,16,2024-07-23 10:36:05.478732+00:00,21,False,10.36,1,7,-5
557,1,2024-07-23 02:03:01.134413+00:00,11,True,02.03,1,7,-10
558,6,2024-07-23 06:24:35.150681+00:00,2,True,06.24,1,7,4
559,11,2024-07-23 23:23:51.648388+00:00,25,False,23.23,1,7,-14
560,11,2024-07-23 03:36:25.340848+00:00,25,True,03.36,1,7,-14
561,9,2024-07-23 16:52:23.325169+00:00,8,False,16.52,1,7,1
562,11,2024-07-23 03:51:33.396690+00:00,11,True,03.51,1,7,0
563,11,2024-07-23 06:55:39.941553+00:00,2,True,06.55,1,7,9
564,23,2024-07-23 17:51:40.053805+00:00,3,False,17.51,1,7,20
565,29,2024-07-23 02:01:14.749994+00:00,28,True,02.01,1,7,1
566,26,2024-07-23 16:51:30.718595+00:00,20,True,16.51,1,7,6
567,16,2024-07-23 00:52:33.500497+00:00,0,True,00.52,1,7,16
568,12,2024-07-23 08:42:06.305744+00:00,30,True,08.42,1,7,-18
569,3,2024-07-23 03:58:30.968683+00:00,13,True,03.58,1,7,-10
570,15,2024-07-23 11:40:50.339806+00:00,11,True,11.40,1,7,4
571,4,2024-07-23 12:55:02.664120+00:00,22,False,12.55,1,7,-18
572,19,2024-07-23 09:20:55.352912+00:00,4,True,09.20,1,7,15
573,21,2024-07-23 00:36:04.685683+00:00,23,False,00.36,1,7,-2
574,18,2024-07-23 00:13:45.340030+00:00,6,True,00.13,1,7,12
575,14,2024-07-23 01:36:10.441445+00:00,24,False,01.36,1,7,-10
576,12,2024-07-23 05:09:17.354074+00:00,9,True,05.09,1,7,3
577,28,2024-07-23 12:11:05.066508+00:00,21,True,12.11,1,7,7
578,15,2024-07-23 00:23:28.943093+00:00,26,True,00.23,1,7,-11
579,21,2024-07-23 01:06:43.871242+00:00,26,True,01.06,1,7,-5
580,7,2024-07-23 08:29:24.714136+00:00,20,False,08.29,1,7,-13
581,19,2024-07-23 05:47:54.952889+00:00,5,False,05.47,1,7,14
582,27,2024-07-23 23:20:23.381203+00:00,24,True,23.20,1,7,3
583,19,2024-07-23 16:14:59.974822+00:00,20,True,16.14,1,7,-1
584,18,2024-07-23 16:07:32.748563+00:00,7,False,16.07,1,7,11
585,29,2024-07-23 12:10:14.634059+00:00,30,False,12.10,1,7,-1
586,12,2024-07-23 00:20:55.491746+00:00,15,False,00.20,1,7,-3
587,6,2024-07-23 05:02:26.651201+00:00,17,False,05.02,1,7,-11
588,5,2024-07-23 17:45:46.266017+00:00,29,False,17.45,1,7,-24
589,24,2024-07-23 20:33:14.243300+00:00,0,True,20.33,1,7,24
590,2,2024-07-23 19:32:31.937974+00:00,24,True,19.32,1,7,-22
591,27,2024-07-23 07:07:10.973525+00:00,23,True,07.07,1,7,4
592,29,2024-07-23 00:32:08.627689+00:00,6,True,00.32,1,7,23
593,6,2024-07-23 11:09:30.302198+00:00,8,True,11.09,1,7,-2
594,9,2024-07-23 14:43:29.243774+00:00,22,False,14.43,1,7,-13
595,22,2024-07-23 18:22:17.408188+00:00,8,False,18.22,1,7,14
596,5,2024-07-23 03:10:21.864375+00:00,15,False,03.10,1,7,-10
597,30,2024-07-23 23:14:35.140978+00:00,3,False,23.14,1,7,27
598,0,2024-07-23 06:33:39.553350+00:00,16,False,06.33,1,7,-16
599,27,2024-07-23 08:10:52.578864+00:00,11,False,08.10,1,7,16
600,15,2024-07-23 04:56:47.435156+00:00,7,True,04.56,1,7,8
601,16,2024-07-23 17:27:01.049221+00:00,6,True,17.27,1,7,10
602,3,2024-07-23 22:33:37.410430+00:00,26,True,22.33,1,7,-23
603,21,2024-07-23 09:44:42.232301+00:00,2,False,09.44,1,7,19
604,20,2024-07-23 23:00:54.431121+00:00,9,False,23.00,1,7,11
605,14,2024-07-23 15:13:25.295729+00:00,28,True,15.13,1,7,-14
606,24,2024-07-23 03:36:44.404503+00:00,26,True,03.36,1,7,-2
607,18,2024-07-23 05:29:20.854048+00:00,11,False,05.29,1,7,7
608,26,2024-07-23 10:56:49.472689+00:00,17,True,10.56,1,7,9
609,21,2024-07-23 11:45:57.142291+00:00,21,False,11.45,1,7,0
610,8,2024-07-23 09:52:46.967917+00:00,23,False,09.52,1,7,-15
611,22,2024-07-23 12:59:04.425272+00:00,18,True,12.59,1,7,4
612,0,2024-07-23 23:47:40.118992+00:00,16,False,23.47,1,7,-16
613,16,2024-07-23 20:17:23.757967+00:00,14,False,20.17,1,7,2
614,2,2024-07-23 02:59:53.480513+00:00,3,False,02.59,1,7,-1
615,0,2024-07-23 18:53:32.745514+00:00,23,True,18.53,1,7,-23
616,28,2024-07-23 20:08:42.679951+00:00,13,False,20.08,1,7,15
617,24,2024-07-23 22:42:52.350344+00:00,13,True,22.42,1,7,11
618,28,2024-07-23 20:06:35.854278+00:00,25,False,20.06,1,7,3
619,14,2024-07-23 15:07:00.738317+00:00,18,False,15.07,1,7,-4
620,3,2024-07-23 16:02:46.317151+00:00,9,False,16.02,1,7,-6
621,16,2024-07-23 18:30:35.816922+00:00,12,True,18.30,1,7,4
622,16,2024-07-23 12:04:36.264338+00:00,13,False,12.04,1,7,3
623,15,2024-07-23 17:52:20.003738+00:00,8,True,17.52,1,7,7
624,4,2024-07-23 01:11:14.883781+00:00,26,True,01.11,1,7,-22
625,21,2024-07-23 05:24:25.608627+00:00,3,False,05.24,1,7,18
626,16,2024-07-23 01:15:35.627513+00:00,25,False,01.15,1,7,-9
627,10,2024-07-23 14:52:17.709651+00:00,6,False,14.52,1,7,4
628,3,2024-07-23 12:59:30.207290+00:00,26,False,12.59,1,7,-23
629,3,2024-07-23 16:06:27.124729+00:00,26,True,16.06,1,7,-23
630,9,2024-07-23 17:54:56.705489+00:00,5,True,17.54,1,7,4
631,3,2024-07-23 23:52:58.717694+00:00,9,False,23.52,1,7,-6
632,14,2024-07-23 21:37:31.609871+00:00,6,True,21.37,1,7,8
633,24,2024-07-23 10:59:42.583844+00:00,13,True,10.59,1,7,11
634,2,2024-07-23 09:08:43.600623+00:00,17,True,09.08,1,7,-15
635,3,2024-07-23 01:16:02.851550+00:00,7,True,01.16,1,7,-4
636,12,2024-07-23 17:32:24.620956+00:00,7,True,17.32,1,7,5
637,22,2024-07-23 09:52:27.600626+00:00,2,False,09.52,1,7,20
638,29,2024-07-23 09:36:57.215653+00:00,11,False,09.36,1,7,18
639,30,2024-07-23 03:32:28.829472+00:00,21,True,03.32,1,7,9
640,21,2024-07-23 01:38:37.274084+00:00,6,True,01.38,1,7,15
641,26,2024-07-23 13:40:58.583959+00:00,10,True,13.40,1,7,16
642,8,2024-07-23 22:49:03.914340+00:00,16,True,22.49,1,7,-8
643,3,2024-07-23 20:07:16.371033+00:00,15,True,20.07,1,7,-12
644,29,2024-07-23 04:18:24.803009+00:00,19,True,04.18,1,7,10
645,14,2024-07-23 12:39:39.964851+00:00,24,False,12.39,1,7,-10
646,20,2024-07-23 08:11:23.085623+00:00,4,True,08.11,1,7,16
647,11,2024-07-23 22:29:55.151606+00:00,28,True,22.29,1,7,-17
648,4,2024-07-23 13:25:43.750909+00:00,13,False,13.25,1,7,-9
649,11,2024-07-23 02:51:24.925749+00:00,28,True,02.51,1,7,-17
650,0,2024-07-23 06:46:57.881213+00:00,27,False,06.46,1,7,-27
651,2,2024-07-23 05:21:09.890623+00:00,29,True,05.21,1,7,-27
652,23,2024-07-23 21:02:18.662064+00:00,29,False,21.02,1,7,-6
653,12,2024-07-23 09:54:36.748460+00:00,21,False,09.54,1,7,-9
654,26,2024-07-23 10:49:09.304447+00:00,12,False,10.49,1,7,14
655,25,2024-07-23 10:07:22.047362+00:00,27,False,10.07,1,7,-2
656,7,2024-07-23 18:56:10.658647+00:00,21,True,18.56,1,7,-14
657,10,2024-07-23 03:17:02.170342+00:00,8,True,03.17,1,7,2
658,23,2024-07-23 05:45:15.018655+00:00,1,True,05.45,1,7,22
659,13,2024-07-23 16:38:20.158489+00:00,5,False,16.38,1,7,8
660,18,2024-07-23 23:28:03.484830+00:00,2,False,23.28,1,7,16
661,25,2024-07-23 17:34:58.451372+00:00,3,True,17.34,1,7,22
662,16,2024-07-23 15:57:26.682705+00:00,9,False,15.57,1,7,7
663,21,2024-07-23 19:05:50.835080+00:00,30,True,19.05,1,7,-9
664,4,2024-07-23 02:53:36.770010+00:00,10,False,02.53,1,7,-6
665,24,2024-07-23 06:18:03.199152+00:00,24,False,06.18,1,7,0
666,24,2024-07-23 04:38:12.964400+00:00,5,False,04.38,1,7,19
667,12,2024-07-23 01:49:39.600451+00:00,6,False,01.49,1,7,6
668,25,2024-07-23 01:08:49.424806+00:00,14,False,01.08,1,7,11
669,12,2024-07-23 08:41:13.367901+00:00,27,True,08.41,1,7,-15
670,5,2024-07-23 23:00:56.101633+00:00,6,True,23.00,1,7,-1
671,13,2024-07-23 00:53:04.772242+00:00,29,True,00.53,1,7,-16
672,5,2024-07-23 15:28:24.411165+00:00,26,True,15.28,1,7,-21
673,0,2024-07-23 00:46:15.561987+00:00,26,True,00.46,1,7,-26
674,5,2024-07-23 12:21:10.320879+00:00,4,False,12.21,1,7,1
675,19,2024-07-23 19:32:18.242446+00:00,20,False,19.32,1,7,-1
676,1,2024-07-23 17:15:21.664018+00:00,23,False,17.15,1,7,-22
677,16,2024-07-23 23:13:51.592829+00:00,15,False,23.13,1,7,1
678,16,2024-07-23 19:42:30.078000+00:00,7,False,19.42,1,7,9
679,2,2024-07-23 15:44:23.991012+00:00,25,True,15.44,1,7,-23
680,14,2024-07-23 14:33:17.526764+00:00,18,False,14.33,1,7,-4
681,29,2024-07-24 00:10:35.994120+00:00,4,True,00.10,2,7,25
682,23,2024-07-23 07:45:43.383642+00:00,8,True,07.45,1,7,15
683,9,2024-07-23 12:54:45.501480+00:00,2,False,12.54,1,7,7
684,10,2024-07-23 03:04:32.289254+00:00,28,False,03.04,1,7,-18
685,20,2024-07-23 05:40:04.214088+00:00,20,False,05.40,1,7,0
686,24,2024-07-23 20:53:46.263378+00:00,16,False,20.53,1,7,8
687,26,2024-07-23 06:06:00.657513+00:00,11,True,06.06,1,7,15
688,1,2024-07-23 01:00:18.709166+00:00,13,False,01.00,1,7,-12
689,24,2024-07-23 11:24:11.933754+00:00,6,False,11.24,1,7,18
690,6,2024-07-23 00:25:13.653843+00:00,25,True,00.25,1,7,-19
691,15,2024-07-23 04:59:40.893485+00:00,28,False,04.59,1,7,-13
692,19,2024-07-23 16:19:34.291625+00:00,21,False,16.19,1,7,-2
693,17,2024-07-23 15:01:43.439415+00:00,25,False,15.01,1,7,-8
694,0,2024-07-23 15:05:34.933798+00:00,22,True,15.05,1,7,-22
695,12,2024-07-23 16:22:22.225706+00:00,21,True,16.22,1,7,-9
696,26,2024-07-23 12:26:56.051577+00:00,9,False,12.26,1,7,17
697,26,2024-07-23 18:42:13.081234+00:00,9,True,18.42,1,7,17
698,0,2024-07-24 00:01:01.551584+00:00,28,True,00.01,2,7,-28
699,5,2024-07-23 22:47:52.176307+00:00,27,False,22.47,1,7,-22
700,27,2024-07-23 19:39:02.896777+00:00,18,True,19.39,1,7,9
701,8,2024-07-23 09:04:50.260845+00:00,1,True,09.04,1,7,7
702,13,2024-07-23 21:31:41.101670+00:00,1,False,21.31,1,7,12
703,11,2024-07-23 20:57:44.602483+00:00,2,True,20.57,1,7,9
704,23,2024-07-23 04:39:57.214819+00:00,17,True,04.39,1,7,6
705,8,2024-07-23 14:36:33.058765+00:00,23,False,14.36,1,7,-15
706,7,2024-07-23 19:44:35.991086+00:00,3,True,19.44,1,7,4
707,22,2024-07-23 10:55:29.265000+00:00,20,False,10.55,1,7,2
708,20,2024-07-23 02:12:16.766501+00:00,1,True,02.12,1,7,19
709,11,2024-07-23 08:44:13.787170+00:00,1,True,08.44,1,7,10
710,20,2024-07-23 07:54:45.192669+00:00,21,False,07.54,1,7,-1
711,12,2024-07-23 10:47:14.641586+00:00,14,False,10.47,1,7,-2
712,8,2024-07-23 01:34:00.618289+00:00,4,False,01.34,1,7,4
713,24,2024-07-23 19:52:35.637062+00:00,15,True,19.52,1,7,9
714,10,2024-07-23 14:26:44.469547+00:00,14,True,14.26,1,7,-4
715,9,2024-07-23 16:56:13.619452+00:00,16,False,16.56,1,7,-7
716,0,2024-07-23 18:27:19.130035+00:00,4,False,18.27,1,7,-4
717,30,2024-07-23 00:40:32.327434+00:00,22,True,00.40,1,7,8
718,26,2024-07-23 01:42:06.937861+00:00,6,False,01.42,1,7,20
719,29,2024-07-23 16:53:06.055154+00:00,6,False,16.53,1,7,23
720,30,2024-07-23 07:50:59.248181+00:00,0,True,07.50,1,7,30
721,16,2024-07-23 07:32:03.206145+00:00,23,True,07.32,1,7,-7
722,18,2024-07-23 14:25:56.552611+00:00,3,False,14.25,1,7,15
723,25,2024-07-23 12:29:53.150664+00:00,3,False,12.29,1,7,22
724,0,2024-07-23 02:28:52.375901+00:00,24,False,02.28,1,7,-24
725,24,2024-07-23 01:14:23.042417+00:00,12,True,01.14,1,7,12
726,18,2024-07-23 07:42:43.087762+00:00,17,True,07.42,1,7,1
727,1,2024-07-23 10:32:39.918670+00:00,1,True,10.32,1,7,0
728,4,2024-07-23 23:55:09.112458+00:00,26,True,23.55,1,7,-22
729,27,2024-07-23 02:20:25.086062+00:00,13,True,02.20,1,7,14
730,10,2024-07-23 16:31:36.211087+00:00,22,True,16.31,1,7,-12
731,6,2024-07-23 07:05:28.424421+00:00,10,False,07.05,1,7,-4
732,11,2024-07-23 10:45:03.517621+00:00,5,True,10.45,1,7,6
733,3,2024-07-23 04:08:21.282933+00:00,7,True,04.08,1,7,-4
734,3,2024-07-23 23:06:28.251454+00:00,19,True,23.06,1,7,-16
735,11,2024-07-23 12:38:58.673900+00:00,3,False,12.38,1,7,8
736,16,2024-07-23 22:07:03.293560+00:00,15,False,22.07,1,7,1
737,0,2024-07-23 16:31:34.139024+00:00,2,True,16.31,1,7,-2
738,4,2024-07-23 15:52:49.875022+00:00,6,False,15.52,1,7,-2
739,25,2024-07-23 15:17:25.159025+00:00,4,True,15.17,1,7,21
740,14,2024-07-23 23:53:17.166881+00:00,5,True,23.53,1,7,9
741,9,2024-07-23 20:32:47.078175+00:00,4,True,20.32,1,7,5
742,18,2024-07-23 14:58:34.269338+00:00,29,True,14.58,1,7,-11
743,12,2024-07-23 11:11:41.216337+00:00,30,False,11.11,1,7,-18
744,13,2024-07-23 01:24:50.063000+00:00,23,False,01.24,1,7,-10
745,15,2024-07-23 18:27:53.732313+00:00,0,False,18.27,1,7,15
746,20,2024-07-23 10:00:47.070462+00:00,26,False,10.00,1,7,-6
747,2,2024-07-23 03:20:45.430902+00:00,1,True,03.20,1,7,1
748,5,2024-07-23 07:31:04.458041+00:00,18,True,07.31,1,7,-13
749,18,2024-07-23 20:33:15.806873+00:00,22,False,20.33,1,7,-4
750,10,2024-07-23 04:51:37.410663+00:00,27,False,04.51,1,7,-17
751,9,2024-07-23 20:39:07.665045+00:00,3,False,20.39,1,7,6
752,25,2024-07-23 23:21:01.627219+00:00,9,False,23.21,1,7,16
753,6,2024-07-23 08:01:19.743623+00:00,21,False,08.01,1,7,-15
754,24,2024-07-23 12:39:47.253536+00:00,28,True,12.39,1,7,-4
755,20,2024-07-23 09:51:27.902702+00:00,24,True,09.51,1,7,-4
756,30,2024-07-23 18:05:56.676531+00:00,21,True,18.05,1,7,9
757,29,2024-07-23 08:55:09.655109+00:00,15,True,08.55,1,7,14
758,8,2024-07-23 21:58:31.808100+00:00,23,False,21.58,1,7,-15
759,16,2024-07-23 18:37:58.347862+00:00,13,False,18.37,1,7,3
760,0,2024-07-23 08:10:14.693819+00:00,15,False,08.10,1,7,-15
761,11,2024-07-23 20:21:52.609899+00:00,8,False,20.21,1,7,3
762,23,2024-07-23 19:07:53.420384+00:00,18,False,19.07,1,7,5
763,27,2024-07-23 12:52:25.751474+00:00,19,True,12.52,1,7,8
764,14,2024-07-23 14:14:56.766316+00:00,13,True,14.14,1,7,1
765,6,2024-07-23 12:24:11.359404+00:00,21,False,12.24,1,7,-15
766,7,2024-07-23 20:58:37.999057+00:00,5,False,20.58,1,7,2
767,9,2024-07-23 10:30:10.652705+00:00,15,False,10.30,1,7,-6
768,15,2024-07-23 13:45:59.525089+00:00,28,False,13.45,1,7,-13
769,18,2024-07-23 18:53:44.368246+00:00,21,True,18.53,1,7,-3
770,2,2024-07-23 23:29:51.081520+00:00,30,True,23.29,1,7,-28
771,16,2024-07-23 14:03:43.543930+00:00,7,False,14.03,1,7,9
772,14,2024-07-23 03:02:13.856763+00:00,8,False,03.02,1,7,6
773,2,2024-07-23 06:28:42.340644+00:00,21,True,06.28,1,7,-19
774,23,2024-07-23 22:19:28.585845+00:00,3,True,22.19,1,7,20
775,9,2024-07-23 11:52:26.842868+00:00,0,False,11.52,1,7,9
776,29,2024-07-23 04:27:07.011942+00:00,7,True,04.27,1,7,22
777,8,2024-07-23 17:28:52.800578+00:00,29,True,17.28,1,7,-21
778,0,2024-07-23 00:28:31.564272+00:00,4,True,00.28,1,7,-4
779,2,2024-07-23 13:36:03.616798+00:00,5,False,13.36,1,7,-3
780,13,2024-07-23 00:28:45.096498+00:00,21,True,00.28,1,7,-8
781,26,2024-07-23 14:43:38.534855+00:00,2,False,14.43,1,7,24
782,21,2024-07-23 23:09:02.617543+00:00,30,True,23.09,1,7,-9
783,7,2024-07-23 20:58:53.513429+00:00,3,False,20.58,1,7,4
784,5,2024-07-23 21:21:18.310717+00:00,20,True,21.21,1,7,-15
785,16,2024-07-23 14:11:53.904476+00:00,8,False,14.11,1,7,8
786,7,2024-07-23 10:51:47.930484+00:00,17,True,10.51,1,7,-10
787,15,2024-07-23 08:03:12.941339+00:00,1,False,08.03,1,7,14
788,16,2024-07-23 03:07:32.111223+00:00,1,True,03.07,1,7,15
789,17,2024-07-23 23:23:26.599176+00:00,13,False,23.23,1,7,4
790,9,2024-07-23 20:00:33.887869+00:00,27,True,20.00,1,7,-18
791,29,2024-07-23 10:03:39.613385+00:00,21,False,10.03,1,7,8
792,24,2024-07-23 20:32:27.662997+00:00,21,False,20.32,1,7,3
793,30,2024-07-23 10:36:43.718012+00:00,11,False,10.36,1,7,19
794,14,2024-07-23 00:28:07.227377+00:00,10,False,00.28,1,7,4
795,0,2024-07-23 06:17:09.172873+00:00,25,False,06.17,1,7,-25
796,16,2024-07-23 02:57:36.266748+00:00,2,False,02.57,1,7,14
797,29,2024-07-23 07:49:40.676774+00:00,27,False,07.49,1,7,2
798,15,2024-07-23 01:38:37.067045+00:00,9,False,01.38,1,7,6
799,7,2024-07-23 23:46:39.900585+00:00,8,True,23.46,1,7,-1
800,15,2024-07-23 13:44:12.785872+00:00,10,True,13.44,1,7,5
801,4,2024-07-23 23:17:33.013846+00:00,19,True,23.17,1,7,-15
802,17,2024-07-23 16:03:12.547419+00:00,7,False,16.03,1,7,10
803,22,2024-07-23 14:09:29.862478+00:00,3,True,14.09,1,7,19
804,12,2024-07-23 14:23:40.396615+00:00,10,False,14.23,1,7,2
805,22,2024-07-23 13:15:00.925435+00:00,12,False,13.15,1,7,10
806,7,2024-07-23 17:30:07.931436+00:00,14,False,17.30,1,7,-7
807,17,2024-07-23 09:53:54.578819+00:00,16,True,09.53,1,7,1
808,14,2024-07-23 23:01:17.959740+00:00,19,True,23.01,1,7,-5
809,9,2024-07-23 19:30:23.237374+00:00,13,True,19.30,1,7,-4
810,12,2024-07-23 12:37:15.327552+00:00,7,True,12.37,1,7,5
811,4,2024-07-23 15:34:13.074156+00:00,17,True,15.34,1,7,-13
812,19,2024-07-23 13:21:23.933504+00:00,17,True,13.21,1,7,2
813,2,2024-07-23 13:41:02.668793+00:00,13,False,13.41,1,7,-11
814,25,2024-07-23 01:53:44.803091+00:00,11,False,01.53,1,7,14
815,7,2024-07-23 04:29:26.409902+00:00,10,True,04.29,1,7,-3
816,27,2024-07-23 05:05:51.326120+00:00,2,False,05.05,1,7,25
817,30,2024-07-23 22:25:49.266491+00:00,19,False,22.25,1,7,11
818,6,2024-07-23 08:49:26.929059+00:00,15,False,08.49,1,7,-9
819,2,2024-07-23 21:34:15.085227+00:00,14,True,21.34,1,7,-12
820,8,2024-07-23 01:19:59.185269+00:00,21,False,01.19,1,7,-13
821,10,2024-07-23 18:42:06.952460+00:00,14,True,18.42,1,7,-4
822,11,2024-07-23 06:03:15.700008+00:00,23,True,06.03,1,7,-12
823,5,2024-07-23 10:36:15.817554+00:00,8,True,10.36,1,7,-3
824,24,2024-07-23 16:38:53.988320+00:00,7,False,16.38,1,7,17
825,27,2024-07-23 14:52:51.306785+00:00,29,True,14.52,1,7,-2
826,9,2024-07-23 16:04:55.575658+00:00,26,False,16.04,1,7,-17
827,7,2024-07-23 22:03:06.958028+00:00,30,True,22.03,1,7,-23
828,16,2024-07-23 11:39:26.697103+00:00,25,False,11.39,1,7,-9
829,23,2024-07-23 15:12:06.902891+00:00,30,True,15.12,1,7,-7
830,8,2024-07-23 07:04:45.325307+00:00,26,True,07.04,1,7,-18
831,1,2024-07-23 12:52:32.776181+00:00,2,True,12.52,1,7,-1
832,29,2024-07-23 07:41:05.484851+00:00,28,True,07.41,1,7,1
833,23,2024-07-23 14:38:49.197255+00:00,11,False,14.38,1,7,12
834,25,2024-07-23 20:33:23.749024+00:00,14,False,20.33,1,7,11
835,29,2024-07-23 03:55:07.411379+00:00,15,False,03.55,1,7,14
836,15,2024-07-23 03:57:15.797922+00:00,14,False,03.57,1,7,1
837,24,2024-07-23 05:36:59.717123+00:00,22,False,05.36,1,7,2
838,25,2024-07-23 05:47:17.385585+00:00,10,False,05.47,1,7,15
839,4,2024-07-23 03:13:53.603046+00:00,16,True,03.13,1,7,-12
840,1,2024-07-23 23:12:01.342632+00:00,11,True,23.12,1,7,-10
841,24,2024-07-23 04:05:11.694450+00:00,21,True,04.05,1,7,3
842,27,2024-07-23 23:07:46.674874+00:00,17,False,23.07,1,7,10
843,18,2024-07-23 04:27:32.513845+00:00,29,True,04.27,1,7,-11
844,12,2024-07-23 23:49:11.093363+00:00,22,False,23.49,1,7,-10
845,2,2024-07-23 14:08:59.981808+00:00,6,True,14.08,1,7,-4
846,22,2024-07-23 08:52:10.009348+00:00,12,False,08.52,1,7,10
847,9,2024-07-23 02:08:51.468322+00:00,3,False,02.08,1,7,6
848,30,2024-07-23 10:24:01.906066+00:00,28,False,10.24,1,7,2
849,23,2024-07-23 18:24:59.456281+00:00,18,True,18.24,1,7,5
850,4,2024-07-23 00:49:24.082130+00:00,9,False,00.49,1,7,-5
851,24,2024-07-23 00:38:57.301643+00:00,30,True,00.38,1,7,-6
852,27,2024-07-23 06:09:22.637462+00:00,22,False,06.09,1,7,5
853,30,2024-07-23 03:31:34.145272+00:00,0,True,03.31,1,7,30
854,16,2024-07-23 06:28:55.652079+00:00,20,True,06.28,1,7,-4
855,10,2024-07-23 17:56:44.311045+00:00,5,False,17.56,1,7,5
856,22,2024-07-23 08:31:17.820193+00:00,13,False,08.31,1,7,9
857,23,2024-07-23 07:17:01.880228+00:00,18,False,07.17,1,7,5
858,27,2024-07-23 12:27:04.681684+00:00,1,True,12.27,1,7,26
859,27,2024-07-23 00:28:49.896658+00:00,20,False,00.28,1,7,7
860,13,2024-07-23 06:01:33.258591+00:00,14,False,06.01,1,7,-1
861,5,2024-07-23 08:41:19.914575+00:00,17,True,08.41,1,7,-12
862,21,2024-07-23 09:51:31.273807+00:00,30,True,09.51,1,7,-9
863,19,2024-07-23 02:20:58.705261+00:00,9,True,02.20,1,7,10
864,28,2024-07-23 20:06:58.066977+00:00,10,False,20.06,1,7,18
865,14,2024-07-23 06:14:51.909757+00:00,21,False,06.14,1,7,-7
866,26,2024-07-23 18:57:55.005374+00:00,1,True,18.57,1,7,25
867,10,2024-07-23 10:47:32.189128+00:00,1,True,10.47,1,7,9
868,18,2024-07-23 02:45:32.446437+00:00,23,False,02.45,1,7,-5
869,11,2024-07-23 18:16:11.968935+00:00,28,False,18.16,1,7,-17
870,7,2024-07-23 23:39:24.562452+00:00,4,False,23.39,1,7,3
871,30,2024-07-23 03:19:05.250042+00:00,17,False,03.19,1,7,13
872,26,2024-07-23 12:02:28.508396+00:00,29,False,12.02,1,7,-3
873,29,2024-07-23 06:02:32.991652+00:00,29,False,06.02,1,7,0
874,16,2024-07-23 07:17:52.408776+00:00,28,True,07.17,1,7,-12
875,20,2024-07-23 04:24:35.430843+00:00,6,True,04.24,1,7,14
876,15,2024-07-23 06:46:53.114396+00:00,0,False,06.46,1,7,15
877,8,2024-07-23 01:36:03.292704+00:00,11,True,01.36,1,7,-3
878,27,2024-07-23 03:25:55.517944+00:00,20,True,03.25,1,7,7
879,10,2024-07-23 16:29:05.674790+00:00,10,False,16.29,1,7,0
880,25,2024-07-23 12:35:55.375795+00:00,3,True,12.35,1,7,22
881,27,2024-07-23 02:59:03.060957+00:00,19,False,02.59,1,7,8
882,2,2024-07-23 15:09:16.151711+00:00,13,False,15.09,1,7,-11
883,29,2024-07-23 23:46:21.379475+00:00,16,True,23.46,1,7,13
884,28,2024-07-23 02:11:28.654384+00:00,29,False,02.11,1,7,-1
885,11,2024-07-23 18:52:07.957881+00:00,6,False,18.52,1,7,5
886,14,2024-07-23 05:45:41.964992+00:00,18,False,05.45,1,7,-4
887,8,2024-07-23 05:05:59.379205+00:00,4,False,05.05,1,7,4
888,1,2024-07-23 23:32:31.923198+00:00,22,False,23.32,1,7,-21
889,11,2024-07-23 01:47:46.602923+00:00,29,False,01.47,1,7,-18
890,6,2024-07-23 05:40:52.774920+00:00,22,True,05.40,1,7,-16
891,22,2024-07-23 22:49:53.584041+00:00,21,True,22.49,1,7,1
892,25,2024-07-23 13:36:29.455144+00:00,15,True,13.36,1,7,10
893,23,2024-07-23 15:33:21.869239+00:00,11,True,15.33,1,7,12
894,18,2024-07-24 00:21:29.621305+00:00,2,False,00.21,2,7,16
895,22,2024-07-23 04:24:20.820615+00:00,28,False,04.24,1,7,-6
897,21,2024-07-23 12:15:49.636961+00:00,30,False,12.15,1,7,-9
898,20,2024-07-23 14:27:04.567103+00:00,8,True,14.27,1,7,12
899,11,2024-07-23 05:02:39.064264+00:00,28,False,05.02,1,7,-17
900,27,2024-07-23 21:00:16.609830+00:00,26,False,21.00,1,7,1
901,25,2024-07-23 12:44:09.988384+00:00,26,True,12.44,1,7,-1
902,4,2024-07-23 21:55:54.431809+00:00,27,True,21.55,1,7,-23
903,26,2024-07-23 17:09:34.430748+00:00,28,True,17.09,1,7,-2
904,0,2024-07-23 21:54:09.227217+00:00,26,False,21.54,1,7,-26
905,6,2024-07-23 02:27:13.946177+00:00,6,False,02.27,1,7,0
906,26,2024-07-23 21:29:17.281776+00:00,24,False,21.29,1,7,2
907,4,2024-07-23 00:50:51.870696+00:00,1,True,00.50,1,7,3
908,14,2024-07-23 19:27:34.635332+00:00,4,False,19.27,1,7,10
909,7,2024-07-23 12:47:59.489199+00:00,0,True,12.47,1,7,7
910,4,2024-07-23 07:59:06.028305+00:00,1,True,07.59,1,7,3
911,23,2024-07-23 05:09:02.236672+00:00,13,True,05.09,1,7,10
912,19,2024-07-23 14:32:43.033444+00:00,4,False,14.32,1,7,15
913,25,2024-07-23 00:43:37.981484+00:00,26,False,00.43,1,7,-1
914,0,2024-07-23 15:14:16.549327+00:00,16,False,15.14,1,7,-16
915,21,2024-07-23 03:52:49.774407+00:00,14,False,03.52,1,7,7
916,24,2024-07-23 19:51:04.760104+00:00,0,True,19.51,1,7,24
917,28,2024-07-23 22:03:44.544720+00:00,19,False,22.03,1,7,9
918,24,2024-07-23 13:20:50.480344+00:00,21,False,13.20,1,7,3
919,18,2024-07-23 16:05:28.901241+00:00,29,True,16.05,1,7,-11
920,30,2024-07-23 12:13:55.529139+00:00,20,True,12.13,1,7,10
921,23,2024-07-23 11:41:46.622318+00:00,27,False,11.41,1,7,-4
922,30,2024-07-23 06:58:23.790452+00:00,25,True,06.58,1,7,5
923,8,2024-07-23 10:10:12.904868+00:00,2,False,10.10,1,7,6
924,8,2024-07-23 06:02:19.757186+00:00,28,True,06.02,1,7,-20
925,27,2024-07-23 18:15:46.985354+00:00,7,False,18.15,1,7,20
926,13,2024-07-23 20:12:48.392002+00:00,18,False,20.12,1,7,-5
927,2,2024-07-23 11:24:19.931593+00:00,8,False,11.24,1,7,-6
928,2,2024-07-24 00:09:10.346314+00:00,16,True,00.09,2,7,-14
929,1,2024-07-23 20:45:36.138493+00:00,25,False,20.45,1,7,-24
930,21,2024-07-23 03:34:27.600675+00:00,1,False,03.34,1,7,20
931,1,2024-07-23 01:03:12.963538+00:00,22,True,01.03,1,7,-21
932,5,2024-07-23 15:44:46.268635+00:00,0,False,15.44,1,7,5
933,9,2024-07-23 09:06:14.707382+00:00,17,True,09.06,1,7,-8
934,3,2024-07-23 21:24:25.143994+00:00,11,True,21.24,1,7,-8
935,18,2024-07-23 17:25:38.188446+00:00,5,False,17.25,1,7,13
936,5,2024-07-23 18:17:03.932327+00:00,5,True,18.17,1,7,0
937,12,2024-07-23 19:27:23.118445+00:00,18,False,19.27,1,7,-6
938,14,2024-07-23 02:37:16.132187+00:00,2,True,02.37,1,7,12
939,9,2024-07-23 00:47:39.916394+00:00,15,True,00.47,1,7,-6
940,22,2024-07-23 21:30:36.856655+00:00,17,True,21.30,1,7,5
941,19,2024-07-23 08:44:16.112291+00:00,0,True,08.44,1,7,19
942,16,2024-07-23 03:06:44.233337+00:00,4,False,03.06,1,7,12
943,5,2024-07-23 15:51:14.044185+00:00,21,False,15.51,1,7,-16
944,7,2024-07-23 18:31:08.714907+00:00,8,True,18.31,1,7,-1
945,3,2024-07-23 23:46:22.959036+00:00,19,True,23.46,1,7,-16
946,10,2024-07-23 05:02:30.134688+00:00,8,False,05.02,1,7,2
947,4,2024-07-23 06:23:24.518122+00:00,7,True,06.23,1,7,-3
948,5,2024-07-23 02:46:09.353025+00:00,18,True,02.46,1,7,-13
949,3,2024-07-23 10:25:35.041568+00:00,21,True,10.25,1,7,-18
950,5,2024-07-23 06:14:15.596351+00:00,10,False,06.14,1,7,-5
951,28,2024-07-23 17:09:12.269504+00:00,30,False,17.09,1,7,-2
952,20,2024-07-23 03:09:14.527916+00:00,14,False,03.09,1,7,6
953,11,2024-07-23 01:37:19.054411+00:00,24,False,01.37,1,7,-13
954,15,2024-07-23 22:53:37.562185+00:00,23,True,22.53,1,7,-8
955,27,2024-07-23 12:35:50.570556+00:00,19,False,12.35,1,7,8
956,15,2024-07-23 01:25:40.963424+00:00,20,True,01.25,1,7,-5
957,29,2024-07-23 01:25:06.119122+00:00,6,True,01.25,1,7,23
958,3,2024-07-23 04:42:14.647275+00:00,20,True,04.42,1,7,-17
959,0,2024-07-23 21:25:00.234969+00:00,8,False,21.25,1,7,-8
960,16,2024-07-23 12:20:59.532572+00:00,17,False,12.20,1,7,-1
961,22,2024-07-23 18:47:52.330927+00:00,13,True,18.47,1,7,9
962,30,2024-07-23 22:35:35.391937+00:00,5,True,22.35,1,7,25
963,4,2024-07-23 12:28:27.971290+00:00,14,True,12.28,1,7,-10
964,10,2024-07-23 02:16:02.245180+00:00,27,False,02.16,1,7,-17
965,23,2024-07-23 12:04:14.477784+00:00,16,False,12.04,1,7,7
966,24,2024-07-23 06:22:39.879079+00:00,26,False,06.22,1,7,-2
967,0,2024-07-23 23:26:41.281277+00:00,8,True,23.26,1,7,-8
968,23,2024-07-23 19:33:21.187746+00:00,24,True,19.33,1,7,-1
969,28,2024-07-23 21:45:40.906338+00:00,0,True,21.45,1,7,28
970,24,2024-07-23 08:00:14.310263+00:00,24,False,08.00,1,7,0
971,16,2024-07-23 10:14:02.705823+00:00,14,False,10.14,1,7,2
972,28,2024-07-23 15:44:18.956612+00:00,3,False,15.44,1,7,25
973,6,2024-07-23 11:43:23.333179+00:00,15,True,11.43,1,7,-9
974,30,2024-07-23 11:49:41.990765+00:00,20,False,11.49,1,7,10
975,16,2024-07-23 08:57:57.373007+00:00,16,True,08.57,1,7,0
976,22,2024-07-23 07:57:08.030187+00:00,16,False,07.57,1,7,6
977,18,2024-07-23 06:03:40.532093+00:00,19,True,06.03,1,7,-1
978,4,2024-07-23 23:45:30.917018+00:00,2,True,23.45,1,7,2
979,22,2024-07-23 20:07:03.790260+00:00,29,True,20.07,1,7,-7
980,29,2024-07-23 19:58:23.622301+00:00,8,False,19.58,1,7,21
981,26,2024-07-23 09:16:11.168322+00:00,23,True,09.16,1,7,3
982,23,2024-07-23 02:50:23.565300+00:00,3,False,02.50,1,7,20
983,0,2024-07-23 02:27:39.128333+00:00,18,True,02.27,1,7,-18
984,9,2024-07-23 18:51:00.864600+00:00,28,True,18.51,1,7,-19
985,6,2024-07-23 06:44:13.614748+00:00,27,True,06.44,1,7,-21
986,18,2024-07-23 03:47:40.763597+00:00,10,True,03.47,1,7,8
987,1,2024-07-23 10:29:14.029718+00:00,17,False,10.29,1,7,-16
988,3,2024-07-23 16:00:17.548741+00:00,4,False,16.00,1,7,-1
989,2,2024-07-23 17:01:56.237202+00:00,21,False,17.01,1,7,-19
990,6,2024-07-24 00:31:24.719153+00:00,14,True,00.31,2,7,-8
991,24,2024-07-23 07:49:59.124316+00:00,28,True,07.49,1,7,-4
992,12,2024-07-23 18:33:53.377225+00:00,17,True,18.33,1,7,-5
993,24,2024-07-23 10:00:56.987914+00:00,3,False,10.00,1,7,21
994,15,2024-07-23 14:07:38.058623+00:00,17,False,14.07,1,7,-2
995,13,2024-07-23 06:26:26.224655+00:00,19,True,06.26,1,7,-6
996,7,2024-07-23 02:48:14.290317+00:00,5,False,02.48,1,7,2
997,0,2024-07-23 03:44:54.159484+00:00,2,False,03.44,1,7,-2
998,21,2024-07-23 22:18:18.227772+00:00,18,False,22.18,1,7,3
999,0,2024-07-23 04:18:52.178046+00:00,27,False,04.18,1,7,-27
1000,9,2024-07-23 07:03:59.507744+00:00,11,False,07.03,1,7,-2
1001,16,2024-07-23 00:59:33.362372+00:00,5,False,00.59,1,7,11
